Kanji	On	Kun
一	ichi;itsu	hito-tsu;hito～
二	ni;ji	futa-tsu;futa～
三	san	mit-tsu;mi～
四	shi	yot-tsu;yon;yo～
五	go	itsu-tsu;itsu～
六	roku	mut-tsu;mutsu;mu;mui～
七	shichi	nana-tsu;nana;nano～
八	hachi;you	yat-tsu;yatsu;ya～
九	ku;kyuu	kokono-tsu;kokono～
十	juu;ji- じっ＝jixtsu	too;to
百	hyaku	momo
千	sen	chi～
上	jou	ue;a-geru;a-garu;nobo-ru;kami～;uwa～
下	ka;ge	shita;sa-geru;sa-garu;kuda-ru;kuda-su;kuda-saru;o-rosu;o-riru;shimo～
左	sa	hidari
右	u;yuu	migi
中	chuu;jyuu	naka
大	dai;tai	oo-kii;oo-ini
小	shou	chii-sai;ko～;o～
月	gatsu;getsu	tsuki
日	nichi;jitsu	hi;～ka
年	nen	toshi
早	sou	haya-i;haya-maru;haya-meru
木	moku;boku	ki;ko
林	rin	hayashi
山	san	yama
川	sen	kawa
土	do;to	tsuchi
空	kuu	sora;a-ku;a-keru;kara
田	den	ta
天	ten	ama
生	sei;shou	i-kiru;u-mu;u-mareru;nama;i-kasu;i-keru;ha-yasu;ha-eru;
花	ka	hana
草	sou	kusa
虫	chuu	mushi
犬	ken	inu
人	jin;nin	hito
名	mei;myou	na
女	jo;nyo	on’na
男	dan;nan	otoko
子	shi;su	ko
目	moku	me
耳	ji	mimi
口	kou	kuchi
手	shu	te
足	soku	ashi
見	ken	mi-ru
音	on	ne;oto
力	riki;ryoku	chikara
気	ki;ke	-
円	en	maru
入	nyuu	hai-ru;i-ru
出	shutsu	de-ru
立	ritsu	ta-tsu
休	kyuu	yasu-mu
先	sen	saki
夕	seki	yuu
本	hon	moto
文	bun;mon	fumi
字	ji	aza
学	gaku	mana-bu
校	kou	-
村	son	mura
町	chou	machi
森	shin	mori
正	sei	tada-shii
水	sui	mizu
火	ka	hi
玉	gyoku	tama
王	ou	-
石	seki	ishi
竹	chiku	take
糸	shi	ito
貝	-	kai
車	sha	kuruma
金	kin	kane
雨	u	ame
赤	seki	aka
青	sei	ao
白	haku	shiro
数	suu	kazu
多	ta	oo-i
少	shou	suku-nai;suko-shi
万	man	yorozu
半	han	naka-ba
形	kei; gyou	katachi
太	ta	futo-i
細	sai	hoso-i
広	kou	hiro-i
長	chou	naga-i
点	ten	bochi△
丸	gan	maru
交	kou	maji-waru
光	kou	hikari;hika-ru
角	kaku	kado;tsuno;sumi
計	kei	haka-ru
直	choku;jiki	tada-chi;nao-su
線	sen	-
矢	shi	ya
弱	jaku	yowa-i
強	kyou	tsuyo-i
高	kou	taka-i
同	dou	ona-ji
親	shin	oya
母	bo	haha;kaa
父	fu	chichi;tou
姉	shi	ane
兄	kei; kyou	ani
弟	tei; dai	otouto
妹	mai	imouto
自	ji; shi	mizuka-ra
友	yuu	tomo
体	tai	karada
毛	mou	ke
頭	tou	atama
顔	gan	kao
首	shu	kubi
心	shin	kokoro
時	ji	toki
曜	you	-
朝	chou	asa
昼	chuu	hiru
夜	ya	yoru
分	fun;bun; bu	wa-karu;wa-keru;wa-kareru;wa-katsu
週	shuu	-
春	shun	haru
夏	ka	natsu
秋	shuu	aki
冬	tou	fuyu
今	kon	ima
新	shin	atara-shii
古	ko	furu-i
間	kan;ken	ma;aida
方	hou	kata
北	hoku	kita
南	nan	minami
東	tou	higashi;azuma
西	sei; sai	nishi
遠	en	too-i
近	kin	chika-i
前	zen	mae
後	go;kou	nochi;ushi-ro;ato
内	nai	uchi
外	gai; ge	soto;hoka;hazu-su
場	jou	ba
地	chi; ji	-
国	koku	kuni
園	en	sono
谷	koku	tani
野	ya	no
原	gen	hara
里	ri	sato
市	shi	ichi
京	kyou; kei	miyako
風	fuu	kaze
雪	setsu	yuki
雲	un	kumo
池	chi	ike
海	kai	umi
岩	gan	iwa
星	sei	hoshi
室	shitsu	muro
戸	ko	to; be
家	ka; ke	ie
寺	ji	tera
通	tsuu	too-ru
門	mon	kado
道	dou	michi
話	wa	hanashi;hana-su
言	gen;gon	i-u;koto
答	tō	kota-eru;kota-e
声	sei	koe
聞	bun; mon	ki-ku
語	go	kata-ru
読	doku	yo-mu
書	sho	ka-ku
記	ki	shiru-su
紙	shi	kami
画	ga; kaku	–
絵	kai	e
図	zu; to	haka-ru
工	kou; ku	–
教	kyou	oshi-eru
晴	sei	hare
思	shi	omo-u
考	kou	kanga-eru
知	chi	shi-ru
才	sai;zai	wazukani;zae
理	ri	kotowari
算	san	–
作	saku	tsuku-ru
元	gen; gan	moto
食	shoku	ta-beru;ku-u
肉	niku	–
馬	ba	uma;ma
牛	gyuu	ushi
魚	gyo	uo;sakana
鳥	chou	tori
羽	u	ha;hane
鳴	mei	na-ku
麦	baku	mugi
米	bei; mai	kome
茶	cha;sa	–
色	shoku	iro
黄	ou	ki
黒	koku	kuro
来	rai	ku-ru
行	kou; gyou	i-ku;yu-ku;okona-u
帰	ki	kae-ru
歩	ho	aru-ku;ayu-mu
走	sou	hashi-ru
止	shi	to-maru
活	katsu	iki-ru;ika-su
店	ten	mise
買	bai	ka-u
売	bai	u-ru
午	go	uma
汽	ki	-
弓	kyuu	yumi
回	kai	–
会	kai; e	a-u
組	so	kumi
船	sen	fune
明	mei	aka-rui
社	sha	yashiro
切	setsu	ki-ru
電	den	–
毎	mai	–
合	gō	a-u
当	tō	a-taru
台	dai; tai	–
楽	raku	tano-shii
公	kou	ōyake
引	in	hi-ku
科	ka	–
歌	ka	uta
刀	tou	katana
番	ban	–
用	you	mochi-iru
何	ka	nani; nan
丁	chō	–
世	sei; se	yo
両	ryō	–
主	shu	nushi;omo-ni;omo-na
乗	jō	no-ru
予	yo	–
事	ji	koto
仕	shi	tsuka-eru
他	ta	hoka
代	dai; tai	ka-waru;yo
住	jū	su-mu
使	shi	tsuka-u
係	kei	kakari;kaka-ru
倍	bai	–
全	zen	matta-ku
具	gu	–
写	sha	utsu-su;utsu-ru
列	retsu	–
助	jo	tasu-keru
勉	ben	tsuto-meru
動	dō	ugo-ku
勝	shō	ka-tsu
化	ka	ba-keru;ba-kasu
区	ku	–
医	i	–
去	kyo or ko	sa-ru
反	han	so-ru
取	shu	to-ru
受	ju	u-keru;u-karu
号	gō	–
向	kō	mu-kau;mu-ku;mu-kou
君	kun	kimi
味	mi	aji;aji-wau
命	mei	inochi
和	wa	–
品	hin	shina
員	in	–
商	shō	–
問	mon	to-i;to-u;ton
坂	–	saka
央	ō	–
始	shi	haji-meru;haji-maru
委	i	yuda-neru
守	shu	mamo-ru
安	an	yasu-i
定	tei;jō	sada-meru;sada-maru
実	jitsu	mi;mino-ru
客	kyaku	–
宮	kyū	miya
宿	shuku	yado;yado-ru
寒	kan	samu-i
対	tai	–
局	kyoku	–
屋	oku	ya
岸	gan	kishi
島	tō	shima
州	shū	–
帳	chō	–
平	hei;byō	tai-ra;hira
幸	kō	saiwa-i;shiawa-se
度	do	–
庫	ko	–
庭	tei	niwa
式	shiki	–
役	yaku	–
待	tai	ma-tsu
急	kyū	iso-gu
息	soku	iki
悪	aku	waru-i
悲	hi	kana-shii
想	sō	–
意	i	–
感	kan	–
所	sho	tokoro
打	da	u-tsu
投	tō	na-geru
拾	–	hiro-u
持	ji	mo-tsu
指	shi	yubi; sa-su
放	hō	hana-su;hana-tsu;hana-reru
整	sei	totono-eru;totono-u
旅	ryo	tabi
族	zoku	–
昔	–	mukashi
昭	shō	–
暑	sho	atsu-i
暗	an	kura-i
曲	kyoku	ma-garu;ma-geru
有	yū	a-ru
服	fuku	–
期	ki	–
板	han or ban	ita
柱	chū	hashira
根	kon	ne
植	shoku	u-eru
業	gyō	–
様	yō	sama
横	ō	yoko
橋	kyō	hashi
次	ji	tsugi;tsu-gu
歯	shi	ha
死	shi	shi-nu
氷	hyō	kōri
決	ketsu	ki-meru;ki-maru
油	yu	abura
波	ha	nami
注	chū	soso-gu
泳	ei	oyo-gu
洋	yō	–
流	ryū	naga-reru
消	shō	ki-eru;ke-su
深	shin	fuka-i
温	on	atata-kai;atata-ka;atata-maru;atata-meru
港	kō	minato
湖	ko	mizūmi
湯	tō	yu
漢	kan	–
炭	tan	sumi
物	butsu;motsu	mono
球	kyū	tama
由	yū or yu	yoshi
申	-	mō-su
界	kai	-
畑	-	hata;hatake
病	byō	yamai
発	hatsu	–
登	tō;to	nobo-ru
皮	hi	kawa
皿	-	sara
相	sō	ai
県	ken	–
真	shin	ma
着	chaku	ki-ru;tsu-ku
短	tan	mijika-i
研	ken	to-gu
礼	rei	–
神	shin;jin	kami
祭	sai	matsu-ri;matsu-ru
福	fuku	–
秒	byō	–
究	kyū	–
章	shō	–
童	dō	–
笛	teki	fue
第	dai	-
筆	hitsu	fude
等	tō	hito-shii
箱	-	hako
級	kyū	–
終	shū	o-waru;o-eru
緑	ryoku	midori
練	ren	ne-ru
羊	yō	hitsuji
美	bi	utsuku-shii
習	shū	nara-u
者	sha	mono
育	iku	soda-tsu;soda-teru;haguku-mu
苦	ku	kuru-shii;kuru-shimu;kuru-shimeru;niga-i;niga-ru
荷	ka	ni
落	raku	o-chiru;otosu
葉	yō	ha
薬	yaku	kusuri
血	ketsu	chi
表	hyō	omote;arawa-su;arawa-reru
詩	shi	–
調	chō	shira-beru
談	dan	–
豆	tō;zu	mame
負	fu	ma-keru;o-u
起	ki	o-kiru;o-kosu;o-koru
路	ro	ji
身	shin	mi
転	ten	koro-bu
軽	kei	karu-i
農	nō	–
返	hen	kae-su;kae-ru
追	tsui	o-u
送	sō	oku-ru
速	soku	haya-i;haya-maru;haya-meru
進	shin	susu-mu
遊	yū	aso-bu
運	un	hako-bu
部	bu	–
都	to;tsu	miyako
配	hai	kuba-ru
酒	shu	sake;saka
重	jū;chō	omo-i;kasa-neru
鉄	tetsu	–
銀	gin	–
開	kai	hira-ku;a-ku;hira-keru;a-keru
院	in	–
陽	yō	–
階	kai	–
集	shū	atsu-maru;atsu-meru
面	men	omo-te;tsura
題	dai	–
飲	in	no-mu
館	kan	yakata
駅	eki	–
鼻	bi	hana
不	fu;bu	–
争	sō	araso-u
付	fu	tsu-ku
令	rei	–
以	i	–
仲	chū	naka
伝	den	tsuta-eru
位	i	kurai
低	tei	hiku-i
例	rei	tato-eru
便	ben;bin	tayo-ri
信	shin	–
倉	sō	kura
候	kō	–
借	shaku	ka-riru
停	tei	–
健	ken	–
側	soku	kawa
働	dō	hatara-ku
億	oku	–
兆	chō	kiza-shi
児	ji;ni	–
共	kyō	tomo
兵	hei;hyō	tsuwamono
典	ten	–
冷	rei	tsume-tai;hi-eru;sa-meru
初	sho	hatsu;haji-me
別	betsu	waka-reru
利	ri	–
刷	satsu	su-ru
副	fuku	–
功	kō	–
加	ka	kuwa-eru
努	do	tsuto-meru
労	rō	negira-u
勇	yū	isa-mu
包	hō	tsutsu-mu
卒	sotsu	–
協	kyō	–
単	tan	–
博	haku	–
印	in	shirushi
参	san	mai-ru
史	shi	–
司	shi	–
各	kaku	ono-ono
告	koku	tsu-geru
周	shū	mawa-ri
唱	shō	tona-eru
喜	ki	yoroko-bu
器	ki	utsuwa
囲	i	kako-u
固	ko	kata-maru
型	kei	kata
堂	dō	–
塩	en	shio
士	shi	–
変	hen	ka-waru
夫	fu fuu bu	otto
失	shitsu	ushina-u
好	kō	su-ku;kono-mu
季	ki	–
孫	son	mago
完	kan	–
官	kan	–
害	gai	–
察	satsu	–
巣	sō	su
差	sa	–
希	ki	mare
席	seki	–
帯	tai	obi
底	tei	soko
府	fu	–
康	kō	–
建	ken	ta-teru
径	kei	–
徒	to	–
得	toku	e-ru
必	hitsu	kanara-zu
念	nen	–
愛	ai	–
成	sei	na-ru
戦	sen	ikusa;tataka-u
折	setsu	o-ru
挙	kyo	a-geru
改	kai	arata-meru
救	kyū	suku-u
敗	hai	yabu-reru
散	san	chi-ru
料	ryō	–
旗	ki	hata
昨	saku	–
景	kei	–
最	sai	mo;motto-mo
望	bō	nozo-mu
未	mi	ima-da
末	matsu	sue
札	satsu	fuda
材	zai	–
束	soku	taba;tsuka
松	shō	matsu
果	ka	ha-tasu
栄	ei	saka-eru
案	an	–
梅	bai	ume
械	kai	–
極	kyoku	kiwa-meru
標	hyō	–
機	ki	hata
欠	ketsu	ka-keru
歴	reki	–
残	zan	noko-ru
殺	satsu	koro-su
毒	doku	–
氏	shi	uji
民	min	tami
求	kyū	moto-mu
治	chi or ji	osa-meru;nao-ru
法	hō	–
泣	kyū	na-ku
浅	sen	asa-i
浴	yoku	abi-ru
清	sei or shō	kiyo-raka
満	man	mi-chiru
漁	ryō or gyō	asa-ru
灯	tō	hi
無	mu or bu	na-i
然	zen or nen	shika-shi
焼	shō	ya-ku
照	shō	te-rasu
熱	netsu	atsu-i
牧	boku	maki
特	toku	–
産	san	u-mu
的	teki	mato
省	sho or sei	habu-ku
祝	shuku	iwa-u
票	hyō	–
種	shu	tane
積	seki	tsu-mu
競	kyō	kiso-u
笑	shō	wara-u
管	kan	kuda
節	setsu	fushi
粉	fun	ko;kona
紀	ki	–
約	yaku	–
結	ketsu	musu-bu;yu-u
給	kyū	tama-u
続	zoku	tsudu-ku
置	chi	o-ku
老	rō	o-iru
胃	i	–
脈	myaku	–
腸	chō	–
臣	shin	–
航	kō	–
良	ryō	yo-i
芸	gei	–
芽	ga	me
英	ei	–
菜	sai	na
街	gai	machi
衣	i	koromo
要	yō	i-ru
覚	kaku	obo-eru;sa-meru
観	kan	mi-ru
訓	kun	–
試	shi	kokoromi-ru;tame-su
説	setsu	to-ku
課	ka	–
議	gi	–
象	zō or shō	–
貨	ka	–
貯	cho	ta-meru
費	hi	tsui-yasu
賞	shō	–
軍	gun	–
輪	rin	wa
辞	ji	ya-meru
辺	hen	ata-ri
連	ren	tsu-reru;tsura-neru
達	–	tachi
選	sen	era-bu
郡	gun	–
量	ryō	–
録	roku	–
鏡	kyō	kagami
関	kan	seki
陸	riku	–
隊	tai	–
静	sei	shizu-ka
順	jun	–
願	gan	nega-u
類	rui	–
飛	hi	to-bu
飯	han	meshi
養	yō	yashina-u
験	ken	–
久	kyū	hisa
仏	hutsu;butsu	hotoke
仮	ka;ke	kari
件	ken	-
任	nin	maka-seru
似	ji	ni-ru
余	yo	ama-ru
価	ka	atai
保	ho	tamo-tsu
修	shū	osa-meru
俵	hyō	tawara
個	ko	-
備	bi	sona-eru
像	zō	-
再	sai;sa	futata-bi
刊	kan	-
判	han	waka-ru
制	sei	-
券	ken	-
則	soku	notto-ru
効	kō	ki-ku
務	mu	tsuto-meru
勢	sei	ikio-i
厚	kō	atsu-i
句	ku	-
可	ka	-
営	ei	itona-mu
因	in	yo-ru
団	dan;ton	-
圧	atsu	-
在	zai	a-ru
均	kin	-
基	ki	moto-duku
報	hō	muku-iru
境	kyō	sakai
墓	bo	haka
増	zō	ma-su;fu-eru
夢	mu	yume
妻	sai	tsuma
婦	fu	-
容	yō	-
寄	ki	yo-ru
富	fu	tomi
導	dō	michibi-ku
居	kyo	i-ru
属	zoku	-
布	fu	nuno
師	shi	-
常	jō	tsune
幹	kan	miki
序	jo	-
弁	ben	-
張	chō	ha-ru
往	ō	-
復	fuku	-
徳	toku	-
志	shi	kokorozashi
応	ō	-
快	kai	kokoroyo-i
性	seishō	saga
恩	on	-
情	jō	nasa-ke
態	tai	-
慣	kan	na-reru
承	shō	uketamawa-ru
技	gi	waza
招	shō	mane-ku
授	ju	sazu-keru
採	sai	to-ru
接	setsu	ses-suru;tsu-gu
提	tei	sa-geru
損	son	soko-neru
支	shi	sasa-eru
政	sei	matsurigoto
故	ko	yue
敵	teki	kataki
断	dan	ta-tsu;kotowa-ru
旧	kyū	-
易	eki	yasa-shii
暴	bō	aba-ku
条	jō	-
枝	shi	eda
査	sa	-
格	kaku	-
桜	ō	sakura
検	ken	-
構	kō	kama-eru
武	bu;mu	-
比	hi	kura-beru
永	ei	naga-i
河	ka	kawa
液	eki	-
混	kon	ma-zaru
減	gen	he-ru
測	soku	haka-ru
準	jun	-
演	en	-
潔	ketsu	isagiyo-i
災	sai	wazawa-i
燃	nen	mo-eru
版	han	-
犯	han	oka-su
状	jō	-
独	doku	hito-ri
率	ritsu;sotsu	hiki-iru
現	gen	arawa-reru
留	ryū ru	todo-maru
略	ryaku	-
益	eki	-
眼	gan	me
破	ha	yabu-ru
確	kaku	tashi-ka
示	shi	shime-su
祖	so	-
禁	kin	-
移	i	utsu-ru
程	tei	hodo
税	zei	-
築	chiku	kizu-ku
精	sei	-
素	su or so	moto
経	kei;kyō	he-ru
統	tō	su-beru
絶	zetsu	ta-tsu
綿	men	wata
総	sō	-
編	hen	a-mu
績	seki	-
織	shiki	o-ru
罪	zai	tsumi
群	gun	mu-reru
義	gi	-
耕	kō	tagaya-su
職	shoku	-
肥	hi	ko-yasu
能	nō	-
興	kyō	oko-su
舌	zetsu	shita
舎	sha	-
術	jutsu	sube
衛	ei	-
製	sei	-
複	fuku	-
規	ki	-
解	ge;kai	to-ku
設	setsu	mouke-ru
許	kyo	yuru-su
証	shō	akashi
評	hyō	-
講	kō	-
謝	sha	ayama-ru
識	shiki	-
護	go	mamo-ru
豊	hō	yuta-ka
財	zai	-
貧	hin	mazushi-i
責	seki	se-meru
貸	tai	ka-su
貿	bō	-
賀	ga	-
資	shi	-
賛	san	-
質	shitsu	-
輸	yu	-
述	jutsu	no-beru
迷	mei	mayo-u
退	tai	shirizo-ku
逆	gyaku	sakara-u
造	zō	tsuku-ru
過	ka	ayama-chi
適	teki	-
酸	san	-
鉱	kō	-
銅	dō	-
銭	sen	zeni
防	bō	fuse-gu
限	gen	kagi-ru
険	ken	kewa-shii
際	sai	kiwa
雑	zatsu	-
非	hi	ara-zu
預	yo	azu-keru
領	ryō	-
額	gaku	hitai
飼	shi	ka-u
並	hei	nami;nara-bu
乱	ran	mida-reru
乳	nyū	chichi
亡	bō	na-kunaru
仁	jin	-
供	kyō;ku	tomo
俳	hai	-
値	chi	atai
傷	shō	kizu
優	yū	yasa-shii
党	tō	-
冊	satsu	-
処	sho	-
刻	koku	kiza-mu
割	katsu	wa-ru
創	sō	tsuku-ru
劇	geki	-
勤	kin	tsuto-meru
危	ki	aya-ui
卵	ran	tamago
厳	gen	kibi-shii
収	shū	osa-meru
后	gō	kisaki
否	hi	ina; iya
吸	kyū	su-u
呼	ko	yo-bu
善	zen	yo-i
困	kon	koma-ru
垂	sui	ta-reru
城	jō	shiro
域	iki	-
奏	sō	kana-deru
奮	hun	huru-u
姿	shi	sugata
存	son	-
孝	kō	-
宅	taku	ie
宇	u	-
宗	shū	sō
宙	chū	-
宝	hō	takara
宣	sen	notama-u
密	mitsu	-
寸	sun	-
専	sen	moppa-ra
射	sha	i-ru
将	shō	-
尊	son	touto-bu
就	shū	tsu-ku
尺	shaku	-
届	-	todo-ku
展	ten	-
層	sō	-
己	ko	onore
巻	kan	ma-ku
幕	maku;baku	-
干	kan	ho-su
幼	yō	osana-i
庁	chō	-
座	za	suwa-ru
延	en	no-basu
律	ritsu	-
従	jū	shitaga-u
忘	bō	wasu-reru
忠	chū	-
憲	ken	-
我	ga	ware
批	hi	-
担	tan	nina-u
拝	hai	oga-mu
拡	kaku	hiro-geru
捨	sha	su-teru
探	tan	saga-su
推	sui	-
揮	ki	-
操	sō	ayatsu-ru
敬	kei	uyama-u
映	ei	utsu-ru
晩	ban	-
暖	dan	atata-kai
暮	bo	ku-rasu
朗	rō	hoga-raka
机	ki	tsukue
枚	mai	-
染	sen	so-meru
株	kabu	-
棒	bō	-
模	mo;bo	-
権	ken	-
樹	ju	ki
欲	yoku	ho-shii
段	dan	-
沿	en	so-u
泉	sen	izumi
洗	sen	ara-u
派	ha	-
済	sai	su-mu
源	gen	minamoto
潮	chō	shio
激	geki	hage-shii
灰	kai	hai
熟	juku	u-reru
片	hen	kata
班	han	-
異	i	koto-naru
疑	gi	utaga-u
痛	tsū	ita-i
皇	kō	ō
盛	sei	mo-ru
盟	mei	-
看	kan	-
砂	sa	sha;suna
磁	ji	-
私	shi	watakushi;watashi
秘	hi	-
穀	koku	-
穴	ketsu	ana
窓	sō	mado
筋	kin	suji
策	saku	-
簡	kan	-
糖	tō	-
系	kei	-
紅	kō	beni;kurenai
納	nō	osa-meru
純	jun	-
絹	ken	kinu
縦	ju	tate
縮	shuku	chidi-mu
署	sho	-
翌	yoku	-
聖	sei	-
肺	hai	-
背	hai	se
胸	kyō	mune
脳	nō	-
腹	fuku	hara
臓	zō	-
臨	rin	nozo-mu
至	shi	ita-ru
若	jaku	waka-i
著	cho	arawa-su;ichijiru-shii
蒸	jō	mu-su
蔵	zō	kura
蚕	san	kaiko
衆	shū	-
裁	sai	saba-ku
装	sō;shō	yosoo-u
裏	ri	ura
補	ho	ogina-u
視	shi	mi-ru
覧	ran	-
討	tō	u-tsu
訪	hō	otozu-reru
訳	yaku	wake
詞	shi	kotoba
誌	shi	-
認	nin	mito-meru
誕	tan	-
誠	sei	makoto
誤	go	ayama-ru
論	ron	-
諸	sho	moro
警	kei	-
貴	ki	-
賃	chin	-
遺	i	-
郵	yū	-
郷	kyou	gou
針	shin	hari
鋼	kou	hagane
閉	hei	shi-meru
閣	kaku	-
降	kou	o-riru
陛	hei	-
除	jo;ji	nozo-ku
障	shou	sawa-ru
難	nan	muzuka-shii
革	kaku	kawa
頂	chou	itada-ku
骨	kotsu	hone
